11111111111111111111111111111111111111111
10001000001000100000001000000000000000101
10101011101010101111101110111011111110101
10101010001010001000101000100010000010101
10111010101111111010101011101010111010101
10000010101000001010100010001010001010101
11111110101011101010111111111011101010101
10000000100010100010000000100010001000101
10101111111110111110111110111010111111101
10100000100010000000100010000010100000001
10111110101011111111101011111110101011111
00001000101010001000001000000010001000001
11111010101010101011111111111111111110111
10001010101000100010000000000000000010001
10101011101111111111101110111011111011101
10100010001000000000001000100010001000001
10111010111011111011111111101110101111101
10001010100010000010000010001000100010001
10101010101111111011111010111011111010111
10101010100010000010001010100000001010001
10101110111010111110101010111111101111101
10100000100010000010100010100000000000001
10101111101110101010111110101111111111101
10101000001010101010000010100010000010101
10111011111010101011111010111110111010101
10100010001000101000001010000000101010101
10101110101111101110111011111111101010101
10101000100000101010000010000000101010000
10101011101110101010101110111110101011111
10101000100010100010101010000010001000001
10101011111010111110101011111011111111101
10100010000010000010100010000010000000101
10111010101011111010111110111110111110101
10001010101010001010000000100010001000001
10101110101011101011111111101110101111111
10100010101000001000001000001000100000101
11111010111111111111101011111011111110101
10000010000000001000100010001010000010101
10111111111011111010111110101110111010101
10000000001000000010000000100000100010001
11111111111111111111111111111111111111111